benefits i	PAY&BENEFITS
High commision paid	PAY&BENEFITS
Benefit offered by this company can be considered as quite good depending on level of position held in the company	PAY&BENEFITS
- harmony working emvironment	WORKPLACE
CIMB Invetsmenr Bank provide a pleasant working environment	WORKPLACE
the flexible working hour	PAY&BENEFITS
medical benefit	PAY&BENEFITS
The company given fun activity sch as gym room	PAY&BENEFITS
pool table in the office block	WORKPLACE
Extra gift for the staff if special target reached	PAY&BENEFITS
Nearby LRT/KTM station	WORKPLACE
The company environment is too good to be experiences	WORKPLACE
The privilege given to their staff like our office our home	WORKPLACE
The benefit offer cannot be competed by any other telcos	PAY&BENEFITS
Got good yearly increment	PAY&BENEFITS
The positivity and environtment	WORKPLACE
Staff benefit & work exposure	PAY&BENEFITS
can get many commission from sale	PAY&BENEFITS
environment working place	WORKPLACE
Salary & benefits	PAY&BENEFITS
Good environment	WORKPLACE
Good bonuses paid with allowances the highest in the Banking Industry	PAY&BENEFITS
salary adjustment	PAY&BENEFITS
bank benefits	PAY&BENEFITS
Culture is one of the motivating factor which I still missed till today	WORKPLACE
The environment of course	WORKPLACE
Perfect office 's utility and good people	WORKPLACE
The working environment and people	WORKPLACE
good environment and independent myself	WORKPLACE
Big benefits	PAY&BENEFITS
Good employee benefits	PAY&BENEFITS
I love the working environment	WORKPLACE
The company also pay good for ot payment	PAY&BENEFITS
Environmental good	WORKPLACE
Challenge comes with great remuniration	PAY&BENEFITS
The management also provide outdoor activities which us in the same department can spend our quality time together	PAY&BENEFITS
- New building	WORKPLACE
easy for transportation if working in Menara CIMB	WORKPLACE
rewards and benefits	PAY&BENEFITS
i love the working environment	WORKPLACE
Incentives quite lucrative	PAY&BENEFITS
The performers get rewarded	PAY&BENEFITS
Lot of incentives trip	PAY&BENEFITS
the office	WORKPLACE
Normal environment	WORKPLACE
The salary n talking to customers	PAY&BENEFITS
Generally benefits were good (again this varies by which entity you're tagged to i	PAY&BENEFITS
very strategic and near to various public transport and other amenities	WORKPLACE
GOOD PLACE FOR YOU TO GAIN GOOD NAME IN YOUR RESUME AND HAVE A GOOD BONUS	PAY&BENEFITS
Good food	PAY&BENEFITS
improve self motivations and the highest paying bank in the country plus rewarding incentives that really improve your personal financial	PAY&BENEFITS
Very good working environment	WORKPLACE
very good benefits & clear career path	PAY&BENEFITS
Provide good analytical tool and training	WORKPLACE
medical benefit	PAY&BENEFITS
annual increment	PAY&BENEFITS
The environment working in CIMB quite good	WORKPLACE
good salary	PAY&BENEFITS
I enjoy working here because of good environment	WORKPLACE
flexible time	PAY&BENEFITS
better salary	PAY&BENEFITS
I enjoy working there with very good environment	WORKPLACE
good EPF payout and bonuses	PAY&BENEFITS
The working ambiance	WORKPLACE
Rewards scheme	PAY&BENEFITS
- good working environment	WORKPLACE
superior and incentives	PAY&BENEFITS
The incentives and rewards really good	PAY&BENEFITS
Staff benefit	PAY&BENEFITS
Medical benefit was good	PAY&BENEFITS
the benefits are great	PAY&BENEFITS
Overall a good working environment where most things are organised	WORKPLACE
The environment	WORKPLACE
very good harmony here	WORKPLACE
Get to travel the whole of Malaysia and the annual leave of 30 days for employees	PAY&BENEFITS
this is an oppurtunity for you guys to grab this lifetime chances to starts earn by your own because this company gives out a very good benefits for it's staffs	PAY&BENEFITS
They are giving better employees benefits than other same industrial line	PAY&BENEFITS
Perks for senoir management are good	PAY&BENEFITS
They have great employee benefits	PAY&BENEFITS
Employee medical benefits	PAY&BENEFITS
car allowance	PAY&BENEFITS
*my off/rest day per week 3 or 4 days	PAY&BENEFITS
*medical benefit	PAY&BENEFITS
Performers are well rewarded	PAY&BENEFITS
Working hour and staff benefit	PAY&BENEFITS
the benefits	PAY&BENEFITS
Good environment	WORKPLACE
Salary high	PAY&BENEFITS
Staff benefit very good	PAY&BENEFITS
HR is currently taking interest employee welfare	PAY&BENEFITS
excellent working environment	WORKPLACE
sense of belonging	WORKPLACE
Another good thing we can overtime for earn more	PAY&BENEFITS
no restrictions to ot	PAY&BENEFITS
Rewards on individual that really performs well	PAY&BENEFITS
good working environment	WORKPLACE
Acceptable incentives	PAY&BENEFITS
Enjoy workplace	WORKPLACE
Happy environment	WORKPLACE
They take care of the well being of the staffs	PAY&BENEFITS
Good Ambiance	WORKPLACE
good place	WORKPLACE
Energetic environment	WORKPLACE
they reward Top Performer with luxury treatment	PAY&BENEFITS
best workplace	WORKPLACE
strategic location	WORKPLACE
The sallary and the allowance	PAY&BENEFITS
Workin environment quit okie	WORKPLACE
peacefull environment	WORKPLACE
Compensation and benefits	PAY&BENEFITS
Salary revision to a new level to resolve inflation issue seems to retain the talents that keep the company moving	PAY&BENEFITS
Cimb offers good salary & benefit package	PAY&BENEFITS
The Cimb's location is very good	WORKPLACE
easy access to public transport	WORKPLACE
Good Working environment	WORKPLACE
Salary paid on time	PAY&BENEFITS
yearly increment	PAY&BENEFITS
yearly fix base Bonus	PAY&BENEFITS
Best working enviroment	WORKPLACE
Insurance coverage	PAY&BENEFITS
Leave capacity and flexi time	PAY&BENEFITS
They pay contract staff based on performance	PAY&BENEFITS
Good benefits and bonus payout	PAY&BENEFITS
Pay is reasonable	PAY&BENEFITS
Good exposure from wide industry coverage	WORKPLACE
Lot of resources	WORKPLACE
Challenging good experience highly payable of bonuses	PAY&BENEFITS
Flexible working hours	PAY&BENEFITS
Good working environment and central location	WORKPLACE
The benefits is the best that other company	PAY&BENEFITS
They pay high for EPF compared to others	PAY&BENEFITS
The staff benefit provided accoding to level of management	PAY&BENEFITS
The lower level management will have better benefits	PAY&BENEFITS
They pay good sales incentives	PAY&BENEFITS
The job has changed my lifestyle by the increase of income	PAY&BENEFITS
friendly environment and co	WORKPLACE
Good working environment	WORKPLACE
good pay	PAY&BENEFITS
Employee benefit	PAY&BENEFITS
Excellent working environment	WORKPLACE
The location	WORKPLACE
The facilities	WORKPLACE
wonderful working environment	WORKPLACE
nice working enviorment	WORKPLACE
great benefit for staff	PAY&BENEFITS
I thrive in a fluctuating environment	WORKPLACE
Working time flexible	PAY&BENEFITS
medial benefit is good because there are coverage on maternity	PAY&BENEFITS
Nice environment with kind amd helpful people	WORKPLACE
High salary & bonuses	PAY&BENEFITS
the environment work here	WORKPLACE
Excellent employee benefits from the company	PAY&BENEFITS
Good benifit from management	PAY&BENEFITS
Freindly environment	WORKPLACE
benefits commensurable	PAY&BENEFITS
Good benefits	PAY&BENEFITS
The salary was also recently restructured	PAY&BENEFITS
this is s great place to work	WORKPLACE
Good benefits	PAY&BENEFITS
Average benefit	PAY&BENEFITS
the office location is convenient since it is near to the public transport	WORKPLACE
there is plenty of eating places around the area	WORKPLACE
part of the culture here	WORKPLACE
Free training for staff is one of the best benefit as staff will be able to learn any other things besides work related job scope	PAY&BENEFITS
Staff benefit and salary increment	PAY&BENEFITS
They also did introduce a child day care at every HQ buildin	PAY&BENEFITS
Fixed annual salary increment for executive ans assistant manager levels	PAY&BENEFITS
average bonus of 3 months	PAY&BENEFITS
other types of appreciation will be given i	PAY&BENEFITS
good medical coverage	PAY&BENEFITS
dental and vision	PAY&BENEFITS
good medical benefits	PAY&BENEFITS
Fringe benefits of the company is good	PAY&BENEFITS
And there is much annual leave	PAY&BENEFITS
The best experience working in the company with the coolest environment	WORKPLACE
Very taking care in staff's charity	PAY&BENEFITS
There are a lot of supports provided to ensure the success of the branch	WORKPLACE
The environment is ok	WORKPLACE
And family days are always the highlight of my year	PAY&BENEFITS
good working environment	WORKPLACE
good employee benefits	PAY&BENEFITS
Benefit on medical which include for family	PAY&BENEFITS
The environment and working place	WORKPLACE
The working environment was superb	WORKPLACE
healthy work environment	WORKPLACE
bonus with high great rewards upon our great achievements	PAY&BENEFITS
full of colors	WORKPLACE
great place	WORKPLACE
The bonus is reasonable well	PAY&BENEFITS
Great place to work	WORKPLACE
well organized listed company that giving good benefits to employee	PAY&BENEFITS
Medical benefits	PAY&BENEFITS
GOOD WORKING ENVIRONMENT FROM COLLEAGUES	WORKPLACE
the benefits	PAY&BENEFITS
incentive wise good	PAY&BENEFITS
no limitations for your incentives	PAY&BENEFITS
You will earn good $ once you exceed the threshold	PAY&BENEFITS
Software system are good	WORKPLACE
pretty good benefits	PAY&BENEFITS
the workplace	WORKPLACE
paid coaches to train you for workout etc)	PAY&BENEFITS
A good place	WORKPLACE
superior and good working environment	WORKPLACE
good environment	WORKPLACE
A very helpful and friendly environment	WORKPLACE
Hardworking ethics are practiced regularly here	WORKPLACE
Benefits are good for old hires only	PAY&BENEFITS
New hires are not entitled to full benefits	PAY&BENEFITS
many benefits	PAY&BENEFITS
Fun working environment	WORKPLACE
High recommend for who looking for experience and good environment to work at	WORKPLACE
Working environment	WORKPLACE
Advance technology and equipment	WORKPLACE
the facilities	WORKPLACE
High pay for ot	PAY&BENEFITS
nice working enviroment	WORKPLACE
The working environment here seems to be cool	WORKPLACE
flexible working hour	PAY&BENEFITS
I enjoy the environment working at the workplace	WORKPLACE
The environment	WORKPLACE
A good environment for fresh grad to expose themselves in a working environment	WORKPLACE
and friendly environment	WORKPLACE
greate benefit	PAY&BENEFITS
I can feel the relax environment here	WORKPLACE
the working environment taught me to work well under pressure	WORKPLACE
Hospitalization benefit and employee welfare	PAY&BENEFITS
If you want extra bonus	PAY&BENEFITS
sales scheme bonus up 12 month max if sale above target	PAY&BENEFITS
Physio at work also cover by PMcare	PAY&BENEFITS
Good benefits (medical	PAY&BENEFITS
leave day) offer to employee	PAY&BENEFITS
Great environment	WORKPLACE
reimburse tuition for education outside of work	PAY&BENEFITS
The environment	WORKPLACE
environment company	WORKPLACE
My employer create very comfortable condition either in workplace or during the event day	WORKPLACE
Comfy and relaxing	WORKPLACE
The best and condusive environment	WORKPLACE
Good benefit	PAY&BENEFITS
The environment is great	WORKPLACE
Company provides an excellent facilities	PAY&BENEFITS
The environment in the office	WORKPLACE
Flexible time management	PAY&BENEFITS
Great exposure	WORKPLACE
travelling all around Malaysia	PAY&BENEFITS
flexible working time	PAY&BENEFITS
travel allowance including meal	PAY&BENEFITS
medical benefits	PAY&BENEFITS
Mature environments	WORKPLACE
spiritual and working environment	WORKPLACE
environment of working	WORKPLACE
other facilities	WORKPLACE
good environment	WORKPLACE
nice workplace	WORKPLACE
good surrounding	WORKPLACE
Company will offers several benefits for us to encourage us	PAY&BENEFITS
good environment	WORKPLACE
Enjoyable working environment and culture with supportive senior who 's willing to guide you in challenging and emerging telecommunication industry	WORKPLACE
Environment working was great	WORKPLACE
great working environment	WORKPLACE
works as a team commission high	PAY&BENEFITS
High pay	PAY&BENEFITS
good enviroment	WORKPLACE
Working environment & staff benefits	PAY&BENEFITS
I m still working with CIMB because of benefit better then other Bank	PAY&BENEFITS
High incentive payout	PAY&BENEFITS
great working embiance	WORKPLACE
Quarterly incentive for BM	PAY&BENEFITS
Good incentive payout	PAY&BENEFITS
Great working environment	WORKPLACE
Great working and workplace environment	WORKPLACE
good senior in learning situation	WORKPLACE
Good working environments	WORKPLACE
Good benefits	PAY&BENEFITS
Friendly environment making your job performance more effective	WORKPLACE
great environment	WORKPLACE
Good benefits	PAY&BENEFITS
Working Environment	WORKPLACE
The work environment is good even work is pressure	WORKPLACE
The salary also good	PAY&BENEFITS
every bonus awarded is fair and opportunities to transfer skills set to another division/ department	PAY&BENEFITS
Very good environment	WORKPLACE
Nice working environment	WORKPLACE
i learn different culture with different countries	WORKPLACE
Nice environment and friendly staff	WORKPLACE
Good employee and colleagues	WORKPLACE
TM Customer Experience Management have a nice working environment	WORKPLACE
Great environment	WORKPLACE
Excellent benefits	PAY&BENEFITS
the office	WORKPLACE
management and work station	WORKPLACE
an environment where employee can openly discuss and share views	WORKPLACE
Friendly environment	WORKPLACE
Benefits for staff and dependents are quite good	PAY&BENEFITS
LRT station nearby	WORKPLACE
Variety of F&B outlets	WORKPLACE
Convenience store in Ground Floor	WORKPLACE
Competitive salary scheme	PAY&BENEFITS
Amazing work environment	WORKPLACE
the overall environment very conducive	WORKPLACE
environment that you rarely can get from other company	WORKPLACE
Great Environment	WORKPLACE
The culture is great	WORKPLACE
Work environment	WORKPLACE
Great reward and recognition	PAY&BENEFITS
Empowerment and exposure	WORKPLACE
good environment	WORKPLACE
the environment is great	WORKPLACE
the environment at the office is suitable to do the work	WORKPLACE
there a lots of benefits provided to the staff	PAY&BENEFITS
High incentive	PAY&BENEFITS
Good benefits	PAY&BENEFITS
good salary	PAY&BENEFITS
work atmosphere	WORKPLACE
Good working environment	WORKPLACE
the environment of working and officemates	WORKPLACE
Working environment make us less stressful with the work load	WORKPLACE
flexiable time	PAY&BENEFITS
Good Incentive Payout	PAY&BENEFITS
Time flexibility & nice environment	PAY&BENEFITS
Telekom Malaysia Berhad offered me a comfortable working environment	WORKPLACE
TM working environment	WORKPLACE
the environment	WORKPLACE
Good benefits	PAY&BENEFITS
flexible working time	PAY&BENEFITS
Flesiblitity working enviroment	PAY&BENEFITS
Flexible working hours	PAY&BENEFITS
very great work environment	WORKPLACE
friendly and inspiring	WORKPLACE
A work place	WORKPLACE
Good working environment	WORKPLACE
great salary	PAY&BENEFITS
working throughout good system & technology	WORKPLACE
enjoy benefit given	PAY&BENEFITS
excellent working environment & friendly co-workers	WORKPLACE
GOOD INCENTIVE SCHEME	PAY&BENEFITS
Time Flexible	PAY&BENEFITS
work like family	WORKPLACE
Staff Benefits Flexible working hours No formal dress code	PAY&BENEFITS
Location and benefits	PAY&BENEFITS
Good Infrastructure with wide work scope	WORKPLACE
Good working experience Good working environment	WORKPLACE
-Well-equipped office to ensure steady workflow	WORKPLACE
this is the best place for retirement	WORKPLACE
medical benefits	PAY&BENEFITS
Great work environment	WORKPLACE
High commission	PAY&BENEFITS
Good working environment and very welcoming staff	WORKPLACE
Provisions for employees basic needs are also excellent	PAY&BENEFITS
The environment	WORKPLACE
gym and surau	PAY&BENEFITS
The salary for starter	PAY&BENEFITS
I love the environment working in TM	WORKPLACE
Allowed to do OT to earn extra	PAY&BENEFITS
Good pay	PAY&BENEFITS
can travel when in site working	PAY&BENEFITS
employees welfare are the best service provided here	PAY&BENEFITS
Flexible working hours	PAY&BENEFITS
Friendly environment	WORKPLACE
flexible working hours	PAY&BENEFITS
Benefits of to the employee	PAY&BENEFITS
The office that I am currently working is nearby to my house	WORKPLACE
so it took me about 45 minutes just to reach here	WORKPLACE
benefit and environent	PAY&BENEFITS
there are many facilities available for staff like security	WORKPLACE
clinic care center	PAY&BENEFITS
food court	WORKPLACE
many lift	WORKPLACE
car park	PAY&BENEFITS
The working time	PAY&BENEFITS
near lrt kerinchi	WORKPLACE
great environment	WORKPLACE
working environment were quite nice especially in for DCX	WORKPLACE
The working environment have a positive vibes	WORKPLACE
Good place	WORKPLACE
good working environment	WORKPLACE
a good environment	WORKPLACE
Reward and Recognition	PAY&BENEFITS
The environment is great	WORKPLACE
Good working environment	WORKPLACE
Flexible off day	PAY&BENEFITS
Professional environment	WORKPLACE
flexible working time	PAY&BENEFITS
The pay is good especially for fresh graduates	PAY&BENEFITS
Challenging and dynamic work environment	WORKPLACE
we can get more allowances	PAY&BENEFITS
More benefit	PAY&BENEFITS
Offer great staff benefit	PAY&BENEFITS
good place	WORKPLACE
Their working environment	WORKPLACE
Full of staff benefits	PAY&BENEFITS
Great income	PAY&BENEFITS
harmony emvironment	WORKPLACE
The benefits that the company given was excellent	PAY&BENEFITS
Benefits is there although not streamlined throughout	PAY&BENEFITS
Family environment	WORKPLACE
Flexible working hours	PAY&BENEFITS
The benefits	PAY&BENEFITS
working environment such as	WORKPLACE
Medical and leave benefits	PAY&BENEFITS
cozy and comfortable	WORKPLACE
have good facilities provided to the staffs	PAY&BENEFITS
The environment of the company	WORKPLACE
positive atmosphere	WORKPLACE
management and surroundings	WORKPLACE
-Facilities in good conditions	WORKPLACE
-High benefits -Balance worktime	PAY&BENEFITS
Great benefits	PAY&BENEFITS
working environment	WORKPLACE
Earn more money and good environment	PAY&BENEFITS
flexible off day environment	PAY&BENEFITS
Great environment to grow my career	WORKPLACE
good working environment	WORKPLACE
The staff benefits	PAY&BENEFITS
Good benefits and salary packages	PAY&BENEFITS
friendly co-workers & positive environment	WORKPLACE
the environment is good	WORKPLACE
a lot of benefit for the staff	PAY&BENEFITS
good work environment	WORKPLACE
Working Enviroment	WORKPLACE
The cozy environment	WORKPLACE
cause the environment is good	WORKPLACE
Good working environment	WORKPLACE
I enjoyed the flexibility of their working time	PAY&BENEFITS
friendly & supportive working environment	WORKPLACE
The culture and team work	WORKPLACE
Best working environment for long term career	WORKPLACE
The work evironment	WORKPLACE
Friends and benefit	PAY&BENEFITS
Employees are well taken care of	PAY&BENEFITS
good environment	WORKPLACE
No more 'photocopy or fotostat girl' here	WORKPLACE
The benefits	PAY&BENEFITS
Salary on par with work	PAY&BENEFITS
Culture and working ethics	WORKPLACE
Great working environment and colleagues that eagerly want to share knowledge to intern student	WORKPLACE
the environment is very good because we are as one family doing work together	WORKPLACE
Good environment	WORKPLACE
Supportive working environment	WORKPLACE
All superior and environment	WORKPLACE
Environtment make me comfortable	WORKPLACE
Good income	PAY&BENEFITS
Good working environment	WORKPLACE
it's near LRT	WORKPLACE
easy to come to work	WORKPLACE
Good colleagues Good surrounding	WORKPLACE
enjoy working enviroment	WORKPLACE
* office surrounding * friends	WORKPLACE
Reward from branch	PAY&BENEFITS
The benefits are super good (for those started before 2010s)	PAY&BENEFITS
good remuneration package	PAY&BENEFITS
working environment	WORKPLACE
Good allowance & nice salary for pernanant staffs	PAY&BENEFITS
The environment of the place	WORKPLACE
The environment is great	WORKPLACE
The environment of the workplace	WORKPLACE
The great things are when you are surrounded by cheerful	WORKPLACE
Condusive environment	WORKPLACE
pretty good benefits / perks	PAY&BENEFITS
Very organised	WORKPLACE
good medical benefit	PAY&BENEFITS
Telekom Malaysia has a good environment suitable for people that like peace	WORKPLACE
good working condition	WORKPLACE
The unique work culture	WORKPLACE
Get more benefit from company	PAY&BENEFITS
system and applications	WORKPLACE
Best Medical Benefit Best experience with college	PAY&BENEFITS
Good place to learn	WORKPLACE
Conducive working environment	WORKPLACE
Good remuneration	PAY&BENEFITS
good benefits	PAY&BENEFITS
nearest working place	WORKPLACE
Convenient location	WORKPLACE
Employer takes a good care their employee such as medical care	PAY&BENEFITS
salary increment	PAY&BENEFITS
good teamwork	WORKPLACE
best working environment	WORKPLACE
It has a lot of facilities such gym as it was big company	PAY&BENEFITS
Always get food from them	PAY&BENEFITS
good enviroment	WORKPLACE
The incentives and benefit	PAY&BENEFITS
Flexibility during working	PAY&BENEFITS
A place	WORKPLACE
the culture	WORKPLACE
the work ethics	WORKPLACE
The environment itself will encourage you want to be a better self	WORKPLACE
wonderful working environment	WORKPLACE
flexible working hours	PAY&BENEFITS
The best ever environment working place	WORKPLACE
Good surroundings there	WORKPLACE
The work environment and people around you	WORKPLACE
The working environment	WORKPLACE
overall system and employee benefits	PAY&BENEFITS
Good benefits	PAY&BENEFITS
while enjoying making a good relationship with co-workers and boses besides a comfort working environment	WORKPLACE
Benefit and working experience	PAY&BENEFITS
SUPPORTIVE ENVIRONMENT	WORKPLACE
Staff benefit	PAY&BENEFITS
flexible time	PAY&BENEFITS
Earn good incentives payments	PAY&BENEFITS
the benefit are way different compared to my previous job	PAY&BENEFITS
Location was decent for people who do not carry own transportation	WORKPLACE
and fiber optic network	WORKPLACE
good environment	WORKPLACE
Good environment	WORKPLACE
Flexible working hour	PAY&BENEFITS
4 days working	PAY&BENEFITS
environment with the staff	WORKPLACE
Nice working environment	WORKPLACE
High pay	PAY&BENEFITS
A very great and positive vibe	WORKPLACE
the stress - free environment	WORKPLACE
good environment to learn	WORKPLACE
Good management and good benefit	PAY&BENEFITS
High commission paid if you hit your target	PAY&BENEFITS
Good environment working here with experience employee	WORKPLACE
Good environment and cliques	WORKPLACE
medical benefit	PAY&BENEFITS
learning network with good colleague	WORKPLACE
very good medical benefit	PAY&BENEFITS
Good benefits	PAY&BENEFITS
bit of government working styles	WORKPLACE
Working environment	WORKPLACE
Many benefit	PAY&BENEFITS
Good environment in company	WORKPLACE
~Friendly staff & Comfortable environment (Back-office)	WORKPLACE
Incentive & trip reward	PAY&BENEFITS
A lot of benefit	PAY&BENEFITS
flexible working habit	PAY&BENEFITS
good benefit	PAY&BENEFITS
good benefits	PAY&BENEFITS
Staff benefits are inferior compared to other organisations	PAY&BENEFITS
Management styles and benefits	PAY&BENEFITS
- There are too much data in the group where it is difficult to gather the information that we need for our analysis	WORKPLACE
so no bank benefit for staff	PAY&BENEFITS
such as bonus	PAY&BENEFITS
traffic jam	WORKPLACE
New working background environments	WORKPLACE
from KL they transfer me to east coast what can I do there	WORKPLACE
Salary & working place	PAY&BENEFITS
Hope the management won't keep change the incentive scheme	PAY&BENEFITS
to be positive & hava happy working environment	WORKPLACE
The benefits of employee	PAY&BENEFITS
The management has promised so many time on the salary revision	PAY&BENEFITS
The huge gap of benefits between the executive level and other level	PAY&BENEFITS
extra hours without additional pay	PAY&BENEFITS
the salary	PAY&BENEFITS
I hope company can reconsider to give a better pay to who in complaint unit because the unit it self a stressful unit	PAY&BENEFITS
Better salary package and benefits for staff	PAY&BENEFITS
Bank starting to cut incentives	PAY&BENEFITS
Bank starting to impose condition for incentive payout	PAY&BENEFITS
Bank just started to double the incentive target	PAY&BENEFITS
Medical benefit normal only	PAY&BENEFITS
Coffee machine out of service	WORKPLACE
especially from salary point of view	PAY&BENEFITS
WORKING ENVIROMENT	WORKPLACE
working enviroment is not that good	WORKPLACE
Less benefits for contract staffs such as medical	PAY&BENEFITS
bonus n increment	PAY&BENEFITS
The reward and recognition system	PAY&BENEFITS
The culture of "talk only do nothing" is very strong	WORKPLACE
working environment quite tuff to handle	WORKPLACE
Timing flexibility	PAY&BENEFITS
Working environment and work culture	WORKPLACE
The pay could be better comparing with seniority	PAY&BENEFITS
Transparent renumeration & reward system	PAY&BENEFITS
Stressful environment	WORKPLACE
Commission base is also very bad	PAY&BENEFITS
since the company cafe closed hard to get food here when its come Ramadhan month need to go outside to get food	WORKPLACE
other than that caring boss and good sallary are quit impressive	PAY&BENEFITS
other benefits such as family medical is the worst among banks	PAY&BENEFITS
Work culture	WORKPLACE
Working culture can be better	WORKPLACE
need to travel for meetings	WORKPLACE
- no laptop	WORKPLACE
To provide the same benefits to higher level management which they also the employee of the company	PAY&BENEFITS
Less stressful working environent	WORKPLACE
Low compensation package	PAY&BENEFITS
to get extra commission	PAY&BENEFITS
to initiate the better benefits compare to other competitors either different business or similar business	PAY&BENEFITS
Weak culture	WORKPLACE
The working hours flexibility is something that the bank should really look into as most of the big company in Malaysia has started to adopt this	PAY&BENEFITS
Annual dinner and family day	PAY&BENEFITS
pay according to the rank	PAY&BENEFITS
Especially on increments	PAY&BENEFITS
Many staff and resources	WORKPLACE
The working ethic and culture	WORKPLACE
I would feel some racism	WORKPLACE
Benefit for contract	PAY&BENEFITS
Compensation should be given to those who deserve	PAY&BENEFITS
im looking for new environment	WORKPLACE
No privacy for the officer at branch when liaised with client as it is open table	WORKPLACE
No room for improvement(choice of work) once you already hit the senior experience	PAY&BENEFITS
--the medical coverage	PAY&BENEFITS
The good environment there	WORKPLACE
low annual increment	PAY&BENEFITS
not so good about salary	PAY&BENEFITS
places of working far away from my home	WORKPLACE
Not enough place to eat	WORKPLACE
Average salary	PAY&BENEFITS
messy desk during the working hour	WORKPLACE
Few choice of public transports	WORKPLACE
Less convenience for people who dont posses own transport	WORKPLACE
Intern also need to bring their own laptop	WORKPLACE
Lack of benefits for contract staff and useless medical card	PAY&BENEFITS
it is not support the hospitalization as per what it is stated	PAY&BENEFITS
Low salary	PAY&BENEFITS
Better increment should be fine	PAY&BENEFITS
The environment is very challenging	WORKPLACE
Salary late	PAY&BENEFITS
i need to travel far from my house -	WORKPLACE
To many system need to be opened and unreliable workstation	WORKPLACE
Limited parking lots	WORKPLACE
working environment	WORKPLACE
Great people and place	WORKPLACE
quite stress environment	WORKPLACE
low salary	PAY&BENEFITS
No flexibility in hours	PAY&BENEFITS
traffic jam during peak hours -	WORKPLACE
no time for new staff to adapt new environment	WORKPLACE
the environment not really clean because of their are producing the cement	WORKPLACE
I would love to see an improvement of benefits for the SL1M trainee especially in medical benefits	PAY&BENEFITS
There is always rooms for improvement for this company especially the facilities	WORKPLACE
LOW INCREMENT	PAY&BENEFITS
Salary on the low side	PAY&BENEFITS
Good benefits	PAY&BENEFITS
The props should have been moved or located to specific room so it wouldn't look too messy	WORKPLACE
low salary	PAY&BENEFITS
give the contract worker some more benefit	PAY&BENEFITS
No public transport	WORKPLACE
low wages as I am only as leasing staff	PAY&BENEFITS
Adjustment salary not tally with the job promotion n gred level	PAY&BENEFITS
Yearly increment is at average level	PAY&BENEFITS
Challenging and dynamic work environment	WORKPLACE
we can get more allowances	PAY&BENEFITS
Changes of technology	WORKPLACE
Good staff with low paid will leave the company for the better offer	PAY&BENEFITS
Average salary	PAY&BENEFITS
benefit that not interesting	PAY&BENEFITS
Line phone slow 2G/3G	WORKPLACE
the salary	PAY&BENEFITS
you have to work on weekend without getting any OT even though you are an intern if your team doesnt have a lot of staff	PAY&BENEFITS
the allowance is too low	PAY&BENEFITS
not to mention that it's bound to be deducted by epf and sosco	PAY&BENEFITS
No OT for interns either	PAY&BENEFITS
So please revise your allowance package especially since it's not cheap to commute to and eat in KL city center	PAY&BENEFITS
Working environment	WORKPLACE
Packed in the elevator everyday during pick hour	WORKPLACE
Add more facility(elevator)	WORKPLACE
i'm enjoy to work here	WORKPLACE
There is no public transport benefits for interns	PAY&BENEFITS
The food sell in this company's cafeteria is a bit pricey	WORKPLACE
the benefit	PAY&BENEFITS
* the salary is quite low	PAY&BENEFITS
Working hours not flexible	PAY&BENEFITS
Salary could be better	PAY&BENEFITS
The distance from home to office	WORKPLACE
Add more space in pantry and make sure it's always clean	WORKPLACE
The operation matters burdened with system limitation	WORKPLACE
Dealing with people and legacy product and systems where no proper documentations documented	WORKPLACE
Don't depended on individual person but create the job equipped with proper work instruction	WORKPLACE
Always traffic	WORKPLACE
always traffic	WORKPLACE
i just want to find a work place which is near to my hometown	WORKPLACE
No benefit	PAY&BENEFITS
Office setup	WORKPLACE
I did not find anything that can make me not enjoy working here	WORKPLACE
This company shall improve more on working environment which is more towards traditional approach	WORKPLACE
No bonus no benefit	PAY&BENEFITS
For instance they should have at least a coffee machines	WORKPLACE
becoming taking a plane from Penang to KL daily just to clock in	WORKPLACE
No OT claims	PAY&BENEFITS
Too many politics and the allowances	PAY&BENEFITS
Long working hour (Can leave on time if achieved daily target)	PAY&BENEFITS
Bad working environment which PC always cause problems and toilet very dirty	WORKPLACE
They force you work over time with no OT	PAY&BENEFITS
Company give more benifit for young guy with no experience	PAY&BENEFITS
