@JetBlue busy due to storm but customer service should always be on point. More so now than ever #getittogether	negative
@JetBlue oh hell no. I'm not waiting again to get hung up on after speaking to 2 #rudeservice people	negative
@JetBlue thank you!! Miss you all so so much!! Is this the link to the blog? Or has that changed?	positive
@JetBlue Thank you!	positive
@JetBlue Is today's JetBlue Flight 918 (NYC-&gt;BOS) delayed? My app says on time and the website says it's not...	negative
@JetBlue to offer service from Daytona Beach to New York - Albany Business Review http://t.co/dUhBJ41jHx	positive
@JetBlue please provide me your direct email for me to explain.	negative
@JetBlue A flight delay due to pilots oversleeping is apparently an uncontrollable irregularity that is not eligible for delay compensation.	negative
@JetBlue sitting on the plane in JFK waiting to take off doors are open catering is stocking up we are delayed but they couldn't be nicer	negative
@JetBlue No worries. Delay was minor and dealt with nicely. It was captain of flight 2324 by the way.	positive
@JetBlue Thanks! Her flight leaves at 2 but she's arriving to the airport early. Wedding is in VT in Sept. Grateful you fly to BTV!! :)	positive
@JetBlue is REALLY getting on my nerves !! ðŸ˜¡ðŸ˜¡ #nothappy	negative
@USAirways is there a better time to call? My flight is on Friday and I need to change it. Worried I may be on hold until then.	negative
@USAirways and when will one of these agents be available to speak?	negative
@USAirways just hung up on me again. Another waste of an hour of my time. How am I supposed to book a one way award flight? #badwebsite	negative
@USAirways you're killing me from the inside	negative
@USAirways is not the new @AmericanAir is more like the new @SpiritAirlines. Love AA. Not impressed with the subpar planes and gate agents.	negative
@USAirways we were moved to a delta direct. Thank you for the accommodations!	positive
@USAirways flight 645 to Phoenix deboards passengers going to Salt Lake City because they can't resolve a simple bathroom issue. #fail	negative
@USAirways always fun to get screwed out of an earlier flight (that isn't full) #crummyservice #whydidntiflysouthwest #goodluckamericanair	negative
@USAirways ok...i know doors close ~10 minutes before takeoff. stop telling me my flight will leave in 20 minutes when we haven't boarded.	negative
@USAirways I finally got through on the phone after a 2 hour wait time.	negative
@USAirways Been stuck for 40+ minutes due to lavatory issues. No beverages. No snacks. No customer service. Flt 645 to PHO... #fail #refund	negative
@USAirways I've been on hold to change a date on a ticket for over 3 hours. Can someone please assist me? Unacceptable.	negative
@USAirways thanks 4 making it impossibly expensive 2 change 2 a flight leaving less than 24 hrs earlier than my reservation #1lesscustomer	negative
@USAirways Well I did miss it. But gate agents had rebooked boarding pass waiting when I landed. Time for lunch &amp; a beverage. Easy cheesy	positive
@USAirways I cant get anyone on the phone to help with award travel.Purchased extra miles and 10 minutes Late Flightr the miles needed was raised.	negative
@USAirways Why haven't you issued a travel advisory for Charlotte Wednesday night and Thursday? 4-6 inches of snow.	negative
@USAirways DeeDee and Lynn S. have been great here in PHX; Richard P. here was a jerk. Rude to us and our parents for no reason.	negative
@USAirways thanks for making me miss my meeting in Dallas. 700 dollars down the toilet ðŸ˜Š	negative
@USAirways I have two tight connections in #Charlotte and #Frankfurt	negative
@USAirways Said only way to get on plane about to leave that would make my connection was a $75 fee. Instead of earlier, I am now Late Flightr!	negative
@USAirways thank you! I will be calling you! #CheapOairChat	positive
@USAirways ur "response" was: my "inconvenience was of no matter." U wanted me sit for 3 xtra nights in the city w/out comp! #donotflyusair	negative
@USAirways getting sorted, thanks	positive
@USAirways Sadly I'm currently booked on one of your flights tomorrow that I will be changing if I can.	negative
@USAirways standby so far for two of us. With snow storm hitting Iowa tomorrow we could be stuck here for two days.	negative
@USAirways thank you!!	positive
@USAirways Why can't I check in online for a flight tomorrow am?	negative
@USAirways - been standing at the gate for 45 min trying to go standby bc I will miss my connection. No help! Do NOT fly US AIRWAYS!	negative
@USAirways after being assured by the pleasant woman at gate B11 in Albany, NY that life's not perfect, I'd heard enough.	negative
@USAirways: u didn't bother following up, we booked with @Delta. @Delta understands cust srv: provided lunch 4 delays &amp; upgraded seats!	negative
@USAirways There is an error w/ my preferred status &amp; I'm not able to reach an agent via phone. Travel Friday. Need resolved - contact info?	negative
@USAirways @AmericanAir how does a pilot forget log book? Been waiting on plane for 45 mins!! #AlsoNoDrinkCartComingAround	negative
@USAirways already did it. One person said they couldn't do anything another said she didn't know why the first person we talked 2 said that	negative
@USAirways @AshleyKAtherton Over an hour on hold so far	negative
@usairways RT @Dmoukdarath: Nice, another delay with @usair second one this trip. Left engine leaking...what's next?? #USAIR #nothappy	negative
@USAirways I want to love you! 43 minutes on hold! Help me understand why I switched loyalty programs. http://t.co/cHGy5yrVka	negative
@USAirways 59 minutes now. Nice customer service you got going on.	negative
@USAirways 44 minutes on hold so far. And still haven't spoke to a human. Never using you again.	negative
@USAirways You have no idea how upset and frustrated I am right now. I'll be sure to follow through with never flying with you again.	negative
@USAirways how can a person go from number one on a standby list to number twelve in three hours? Should I be super platinum diamond status	negative
@USAirways Forget reservations. Thank you to the great leadership at your company, I've Cancelled Flighted my flight. Once again, thank you.	negative
@USAirways great job today from your team with a challenging weather delay on flight 1925 out of Charlotte. #travel #friendlyteam	positive
.@USAirways It was this saturday during all the snow in the DC area. Excited the flight was not Cancelled Flightled but sad he went missing.	negative
@USAirways @AmericanAir I love you guys &amp; I'm gonna let you finish, but I've been on hold for 1 hour trying to book a flight w/ my voucher.	negative
@USAirways And, the helpful employee who changed her boarding zone so that she would have space for her pump is now being disciplined #fail	negative
@USAirways Need to talk to a person about my bag. Waiting on hold for two hours. Bag s!b delivered last night. Online says not found.	negative
@USAirways I don't want your sympathy I want someone to make an effort to find my bag	negative
@USAirways She spoke with someone this AM and was told that breast pumps aren't medical equipment and that she should have "planned better."	negative
@USAirways - 800# referred me back to baggage services but I left the airport. I was on seat 17A	negative
@USAirways thank you very much.	positive
@USAirways - First impressions are hard to reverse. A horrible first experience with you. Will never fly with you again!!!	negative
@USAirways not going as planned is an understatement. My flight was just changed AGAIN. If it weren't for a family emergency, I'd Cancelled Flight.	negative
@USAirways ...2 hours on the plane, they at least got us on a direct flight a couple hours Late Flightr on United	negative
@USAirways sadly that didn't help me at my meeting at work today seeing as my presentation was in there! Major strike against me!!!	negative
.@USAirways I did but the more eyes I have looking for Pandu the better chance I have of bringing him home.	negative
@USAirways my bag is still lost and I can not get anyone on the phone to assist me and the tracking updates have stopped	negative
@USAirways thanks !!!	positive
@USAirways 167 minutes? "Im not trained in that". Cmon. Can't you do better than that?	negative
@USAirways any direct number to dividend miles account info? Every Time I try them I get actually hung up on	negative
@USAirways trying to use chairman upgrade cert for flt 740 on 2/26/14 but being told not an option with 10 open seats? How? Thanks	negative
@USAirways but I've been trying to call them since yesterday and I keep getting hung up on? Can you get me through to them??	negative
@USAirways an award travel ticket but cannot since it is under a different last name. I simply need to change it	negative
@usairways Ok thank youâ€¦I call from Spain to US for seating assistance!	negative
@USAirways 2day: no coffee &amp; 1 working toilet. Then I read domestic airlines whining re: foreign competition. Coincidence? No #openskies	negative
@USAirways I've been on hold to rebook a Cancelled Flighted flight for over two hours. I know weather has a huge impact, but you should anticipate.	negative
@USAirways Been on hold for over 5 hours! I believe I was overcharged $200 for my flight, I need an immediate explanation. HELP	negative
@USAirways I made it- thx.	positive
@USAirways still on hold...1 hr 27 mins....thank god for chairman status. status match @Delta?	negative
@USAirways has the worst customer service. Can't even get through to a rep you gotta be kidding me	negative
@USAirways @Beamske But maybe I can be on hold for 30 minutes again. That would be just as amazing.	negative
@USAirways @Beamske how about a real live person talk to the person whose luggage was lost for 4 days and vacation wrecked . @yorkshire2002	negative
@usairways is your clt departures delayed? Hoping I can make my connection after a lengthy take off delay and endless taxi-ing here at clt	negative
@USAirways I'm glad @Beamske retweeted otherwise you would have to ignore the numerous tweets I sent. You all are fucking amazing	positive
@USAirways So frustrating because I still have not gotten them back. Why my bag was sent to NY is a mystery! Shame on me this time!	negative
@USAirways I will NEVER travel US Airways again. Flew in from LA to DC last night and for the 2nd time on this airline my bags didn't arrive	negative
@USAirways haha no worries you guys are the best! +1 for spelling my name correctly	positive
@USAirways like they will call me? I'v been trying since yesterday and no one is answering...	negative
@USAirways your CSR in PHL suck.  Flt 3883 gets cx'd, i get rebooked to the next day? On standby for 4011. Not hopeful.	negative
@USAirways HELLO!! Is anyone behind your twitter account? #badcustomerservice	negative
@USAirways I keep getting hung up on. PLEASE respond so I can book a ticket with you. I won't be able to buy one unless I speak to someone!	negative
@USAirways hey!! Yeah last time I got a phone call when flight was Cancelled Flightled from DCA to BOS	negative
@USAirways You should be prepared for Weather. All I want to do is find out if I can take train to PHL to catch my connection.	negative
@USAirways When you are deciding to wreck a vacation... is losing luggage from a Cancelled Flighted flight your "go to" maneuver?	negative
@USAirways see you on board tomorrow	positive
@USAirways Been on hold for 40 minutes, calling because my flight is delayed. This type of service in not acceptable.	negative
@USAirways been on hold for 2 hours for something which I could have done in less than 1 minute if it was available.Your site UX is awe full	negative
@USAirways then drop your fee! $150 ($300RT!!!!) makes no sense; most EU airlines charge $0. @AirCanada charges a reasonable $50.	negative
@USAirways i understand that but i should still be able to view my reservation online....	negative
@USAirways another fiasco at National. Forever from jet to gate on 8:05am flight from RDU	negative